{
  "playing_area_width": 615,
  "blocks": [
    [0,0,0,0,0,0,0,0,0,0,0,0,0,0,0,0,0,0,0,0],
    [0,0,0,0,0,0,0,0,0,0,0,0,0,0,0,0,0,0,0,0],
    [0,0,0,0,0,0,0,0,0,0,0,0,0,0,0,0,0,0,0,0],
    [0,0,0,0,0,0,0,1,1,1,1,1,1,0,0,0,0,0,0,0],
    [0,0,0,0,0,0,0,1,1,1,1,1,1,0,0,0,0,0,0,0],
    [0,0,0,0,0,0,0,1,1,1,1,1,1,0,0,0,0,0,0,0]
  ]
}
